Characters:
	Critical Role:
		Grogg Strongjaw: Human Barbarian
		Pike: Gnomish Cleric
		Keyleth: Half Elven druid
		Percy: Gunslinger
		Scandlind Shortheart: Gnomish Bard
		Tyberius Stormwind: Red Dragonborn Sorceror
		Vax: Half elf rogue(?)
		Vex: Half elf ranger (?)
			Trinket: Bear
	Dominions of Essalund:
		?
	Heroes of Awesome:
		Taruil: Wizardy Half Elf
		Arya: Elfy Rogue
		Claire De Lune: Half Elf Ranger
			Milly: Falcon
		Cendia: Human Paladin
	Twilight Chorus:
		Pika: Drow Rogue(dead?)
		Lynja: Human Rogue
		Einhorn: Tifling Bard
		Rosell: Tifling Warlock
		Melasande Falcon: Wood Elf Druid
		Nebo :Gold Dragonborn Fighter
		
		
		
	Titans Grave:
		Aankia: Lizardy gun-wielding engineer
			Jeremy: Robot
		Killel: Ranger Elf-Dwarf
		Lemley: Human-cyborg fighter
			Dr. Lobotomy: arm-sword
		S'Lethkk: Wizardy Half Orc-Lizard
			
			